|               |       |
| | | | | | | | | | | | |     
| | | | | | | |-| | | | |
| | | | | | | | | | | | |
| | | | | | |-| | | | | |
| | | |A| | | | | | | | |
| | | |-| | | | | | | | |
| | | | | | | | | | | | |
| | | | | | | | | | | | |
| | | | | | | | |B| | | |
| | | | | | | | | | | | |
|                       |