|                   |
| | | | | | |-| | | |
| | | | | | | |-| | |
| | | | | | | | | |-|
| | | | | | | | | | |
| | | |A| | | | |   |
|-|-|-|-| |_| | | |B|
| | | | | | | | | |-|
| | | | |   | | | | |
| | | | |_| | | | | |
| | | | | | | | | | |
|                   |